{
  "name": "Level 6: Narrow Shafts",
  "width": 16,
  "height": 9,
  "map": [
    "################",
    "#S....#........#",
    "#.##.#.######..#",
    "#....#......#..#",
    "####.#.####.#..#",
    "#....#....#....#",
    "#.######.#.###E#",
    "#..............#",
    "################"
  ]
}
