{
  "name": "Level 10: Grid Run",
  "width": 16,
  "height": 9,
  "map": [
    "################",
    "#S....#...#....#",
    "#.##.#.#.#.##..#",
    "#....#.#.#..#..#",
    "####.#.#.##.#..#",
    "#....#.#....#..#",
    "#.####.####.#.E#",
    "#..............#",
    "################"
  ]
}
