{
  "name": "Level 4: Switchbacks",
  "width": 15,
  "height": 8,
  "map": [
    "###############",
    "#S...........E#",
    "#.#####.#####.#",
    "#.....#.......#",
    "#.###.#.###.#.#",
    "#.....#.....#.#",
    "#.............#",
    "###############"
  ]
}
