{
  "name": "Level 7: Spike Alley",
  "width": 15,
  "height": 9,
  "map": [
    "###############",
    "#S....#..^....#",
    "#.####..^^^...#",
    "#.....#..^..#.#",
    "#.###.#.###.#.#",
    "#...#.#.....#.#",
    "#.#.#.#####.#E#",
    "#.............#",
    "###############"
  ]
}
