{
  "name": "Level 5: Split Paths",
  "width": 14,
  "height": 9,
  "map": [
    "##############",
    "#S...#.......#",
    "#.#..#.#####.#",
    "#.#..#.....#.#",
    "#.####.###.#.#",
    "#......#...#.#",
    "#.######.#.#.#",
    "#.....E..#...#",
    "##############"
  ]
}
