{
  "name": "Level 2: Vertical Tunnel",
  "width": 13,
  "height": 10,
  "map": [
    "#############",
    "#S..#.......E#",
    "#...#........#",
    "#...#........#",
    "#...#####....#",
    "#............#",
    "#............#",
    "#............#",
    "#............#",
    "#############"
  ]
}
