{
  "name": "Level 1: Gravity Basics",
  "width": 11,
  "height": 6,
  "map": [
    "###########",
    "#.........#",
    "#...S.....#",
    "#.........#",
    "#.....E...#",
    "###########"
  ]
}
