{
  "name": "Level 8: Long Traverse",
  "width": 17,
  "height": 10,
  "map": [
    "#################",
    "#S......#.......#",
    "#.####..#..####.#",
    "#....#..#.......#",
    "#.##.#..#####...#",
    "#..#.#......#...#",
    "#..#.#.####.#.###",
    "#..#.#......#..E#",
    "#..#..........#.#",
    "#################"
  ]
}
