{
  "name": "Level 3: Spike Hazard",
  "width": 15,
  "height": 8,
  "map": [
    "###############",
    "#S............#",
    "#.............#",
    "#....^^^......#",
    "#....^^^......#",
    "#.............#",
    "#.............E#",
    "###############"
  ]
}
