{
  "name": "Level 9: Zigzag",
  "width": 15,
  "height": 8,
  "map": [
    "###############",
    "#S.....#......#",
    "#.###..#..###.#",
    "#.....##..#...#",
    "#.####....#.#.#",
    "#...#..####...#",
    "#...#.....#..E#",
    "###############"
  ]
}
